NO maps/textures/banner.xpm
SO maps/textures/ahegao1.xpm
WE maps/textures/ahegao2.xpm
EA maps/textures/ahegao3.xpm

F 22 ,1  , 
C 255,255,255

        1111111111 11111111111111
        1        1 1            1
        1 11     1 1           1
        1  1     1 1            1
111111111 11  N  1 1            1
1         11    11 11 111111 11111
1111 111111111 11  1      1   1
1111 111111111 11  1 1 1  1   1
11      11 1 1 11  1      1   1
1               1  1      1   1
1               1  1 1 1  1   1
11     111 1 1 11  111 1111   111
1111 111 111 1 1   1 1111 1   1
11111111 1111111   111111111111
