NO maps/textures/Tile1.xpm
SO maps/textures/Tile2.xpm
WE maps/textures/Tile3.xpm
EA maps/textures/Tile4.xpm

F 220,100,0
C 255,255,255

11111111111111111111111111
10001000000000000000000001
10001000000000000000001111
10001111100000000000000001
10000000000000000000000001
10000000000000000000000001
10000000000000000000000001
10000000011101110000000001
10000000000000000000000001
10000000000000000010000001
10000000000000000010000001
10000000000000000010000001
100000000000W0000000000001
11000000000000000010000001
10100000000000000010000001
10000000000000000010000001
11111111111111111111111111
