NO maps/textures/texture1.xpm
SO maps/textures/texture1.xpm
WE maps/textures/texture2.xpm
EA maps/textures/texture3.xpm

F 255,100,0
C 225,30,0

11111111111111111111111111
10000000011111000000000001
11111000000000000000011111
10000001111000000000000001
10000001  1000000000000001
10000001111000000000000011
11111000000000000110111111
10000000000000000000000001
10000000111110111110000001
10000000000000000010000001
10000000100000000000000001
10000000111111111110000001
10000000000000000000000001
10000000000000000000000001
1000000000000000000N000001
11111111111111111111111111
