NO vasco/text
SO vasco/text2
WE vasco/text3
EA vasco/text4

F 220,100,0
C 225,30,0

1111111111111111111
1000001110000000001
1111000000000111111
1000100100000000001
1111000000000000001
1000000000000000001
1000000000000000001
1000000000000000001
1000000000000000001
1000000000000000001
1000011100000000001
1111111111111111111
