NO vasco/text
SO vasco/text2
WE vasco/text3
EA vasco/text4

F 220,100,0
C 225,30,0

11111111111111111111111111
10000000011111000000000001
11111000000000000000011111
10000001111000000000000001
10000001  1000000000000001
10000001111000000000000011
11111000000000000110111111
10000000000000000000000001
10000000111110111110000001
10000000D00000000010000001
100000001000000000D0000001
1000000011111N111110000001
10000000000000000000000001
10000000000000000000000001
1000000000000000000N000001
11111111111111111111111111
