NO vasco/text
SO vasco/text2
WE vasco/text3
EA vasco/text4

F 220,100,0
C 225,30,0

1111111111   1111111111111
10000000011111000000000001
11111000000000000000011111
    100000011110000001
    10000001  10000001
    100000011110000001
1111100000000000011D111111
10000000000000000000000001
1000000011111D111110000001
10000000D00000000010000001
100000001000000000D0000001
1000000011111D111110000001
10000000000000000000000001
10000000000000000000000001
1000000011111110000N000001
111111111     111111111111
111111111     111111111111
