NO maps/textures/enderman.xpm
SO maps/textures/creeper.xpm
EA maps/textures/dirt.xpm
WE maps/textures/gold.xpm

F 220,100,0
C 225,30,0

1111111111   1111111111111
10000000011111000000000001
11111000000000000000011111
    100000011110000001
    10000001  10000001
    100000011110000001
11111000000000000110111111
10000000000000000000000001
10000000111110111110000001
10000000000000000010000001
10000000100000000000000001
1000000011111N111110000001
10000000000000000000000001
10000000000000000000000001
10000000111111100000000001
111111111     111111111111
111111111     111111111111
