NO maps/textures/Tile1.xpm
SO maps/textures/Tile2.xpm
WE maps/textures/Tile3.xpm
EA maps/textures/Tile4.xpm

F 220,100,0
C 255,255,255

11111
10N91
11111
