NO vasco/text
SO vasco/text2
WE vasco/text3
EA vasco/text4

F 220,100,0
C 225,30,0

11111111111111111111111111
10001000000000000000000001
10001000000000000000001111
10001111100000000000000001
10000000000000000000000001
10000000000000000000000001
10000000000000000000000001
10000000011101110000000001
10000000000000000000000001
10000000000000000000000001
10000000000000000000000001
10000000000000000000000001
10000000000000000000000001
11000000000000000000000001
10100000000000000000000001
100000000000N0000000000001
11111111111111111111111111
